#######################
#.....................#
#.....................#
#....g%%%%............#
#....g,,,%............#
#....g%,,%............#
#.....%%%%............#
#.................~~~~#
#.................~~~~#
#.................~~~~#
#######################